1 1
5 11
#######
# #####
# #####
#  ####
## ####
##  ###
### ###
###  ##
#### ##
####  #
##### #
##### #
#######
